1111111111111
1000000000001
1000001111111
1000000000001
1111100000001
1000000000001
1000000011111
1000000111001
1000100000001
1000110011111
1000110000001
1000111100011
10001111000$1
1111111111111